NO ./assets/backrooms.xpm


SO ./assets/backrooms.xpm






WE ./assets/backrooms.xpm

EA ./assets/backrooms.xpm





F       158,        158,        0        



C         150,                 150,             150            

















11111111
10001001
10101001
1N100001
11111111