NO ./assets/jerau.xpm
SO ./assets/wall.xpm
WE ./assets/window.xpm
EA ./assets/door.xpm

F 0,221,0
C 106,201,251

        1111111111111111111111111
        1000000000110000000000001
        1011000001110000000000001
        1001000000000000000000001
111111111011000001110000000000001
100000000011000001110111111111111
11110111111111011100000000001
11110111111111011101010010001
11000000110101011100000010001
10000000000000001100000010001
10000000000000000001010010001
11000001110101011111011110N01
11110111 1110101 100011010001
11111111 1111111 111111111111
