NO ./assets/backrooms.xpm


SO ./assets/backrooms.xpm






WE ./assets/backrooms.xpm

EA ./assets/backrooms.xpm





F       158,        158,        0        



C         150,                 150,             150            

















11111
10001
10N01
10001
11111