111111111111111111111111111111111111111111111111111111111111111111111111111111111111111111111111111111111111111111111111111111111111111111111111111111111111111111111111111111111111111111111111111111111111111111
111111111111111111111111111111111111111111111111111111111111111111111111111111111111111111111111111111111111111111111111111111111111111111111111111111111111111111111111111111111111111111111111111111111111111111
111111111111111111111111111111111111111111111111111111111111111111111111110000011000001000000111111100000000000011000000001111000000000111111111111001100000000001111111111111100111111111111111111111111111111111
110000000000000000000110000000000001111111111111111111111111000000000000000000011000111111100111111101111111110000011000000000001111100000000000000001100011111001111100000000000000110000011111111111100000010011
110011111001001111100111101100000001111111111111111111111111011000000000000000000000000001100110001100000111110011011000011100001111100000111111111000000011011001111100111111111000110010011111111111100110010011
110010011001001100000110000000000001111111111111100000000000011000000000000000011011001101100111001111100000110011000000000000000001000000001111111111110011011001111100000000011000000010000000111111100110010011
110010011001001100111111100011001001111111111111111111111111111000001100000110000011001101100111000000000111110011111110000011000001100111111111111111110011011000001111111110011100001111111110111111100110010011
110010011000000000000000000011000001111111000000000110110000000000111100000001111111000000000111001111100000110000000000000000000001100111111111111111110011000000001111000000000000001111100000111100000110010011
110010011111110011111111111111001001111100000011100110110011011000111111011000000011001111100111001111100000001100111110000011110001100110111111111111111100011000010000000111100011111111100111111100111110010011
110000000001110011111110000000000001111100000010000001110011011000000000000000000011000000000110000000000110000000000000011011000000000110000001111111100000011001110000110110000111110000000000001111111110010011
110011111001110011111110010000001111111000000000000001110011000000111100000001101111111100000000000000000110110011011000000000000000000000110001111111100000000001110000110110000000000001100000001100000110000011
110000011000001111000000010011111111111011110000000000000000000110111100000001100000001100000000000000011110110011011000000000001100000000000011111110000000000000000000110111111100000001111111001100100111111111
111110000111001100000000000000000000000011110000000001111111000001111111000001100011001100000000000011111110000011000000000000000000000000001111111110111111000000000011110000011000000001111111000000100110000011
100010000001000000000001111100001001111111110000000000000000000001111111111000000011000001100000000011111111111111110000011111111101100000001100000110000011000000000000111110011011111111111000001111100111110011
100011111111111100100000000000001001111111110000000000000000000001110000000000000000000110000000000000000000000011000000000000001101100110000000000001110011000000001100111110000000000001111000001111100000000011
100011111111111100100000000000001001111111110000000000000000000001111111111000000000000001100000000011111111110011000000001111111101100111110001100000000011000000000000000000000011110001111001001111111110000001
101111111111111100100111100000001001111111111100000111111100000000000000011110011100000000000011111111111110000011011000000000000001100000000000000001111111111111111111110000000000000000000001001111111110000001
100000000111111100100000001100111001111111111111100111111100000000111111011110011000001101100110000011100000111111011000011100111111111111111100000000111111111000001100000000011100111111111001001100111111101101
110000000001111100100111110000000000000011000001100111110000000000110000011111111000111101100110000011100110000000011000000000111111111111000000000000111111111001101100111000011100000000000001000000000000000001
100000000110000000000000000000111001100011001101100111110000011001110000000000011000001101100110000001100111111111111000001111111111111111111111100110111111111001101100000000000000111111111000001100000111111101
101111100110111100100000000000111000000000001101100110000011000000000000011000000000001101100111000000000110000000011000001111111110000000000001100110111111000000001111110000000011111111111110000000011000000001
101111100000110000011111100000000000011111111101100110111111000000001100011000000000000000000000000001100110000000011110000000000000011111111100000110000011011001100000110000011000000000000000001111011111111101
101111111111110000011111100011111110000000001101100000110000000110001111011000000000000000011111111100000000001100000000001111111100000011111100000110110000000000000000110000000000001111100000001111011000001101
101111100000000000000001100000000000011111001101111000000011000110000000000000000000000000000000000001100111101100000000000000000001100000111100000110000000100110000000110000011100000001100001001111011001100001
101111100001111111111111100000111110000011000001100000000011000111111100000000000011000001111111111100000000111111111000000011111111111110111111000110111100000110000000000111111111110001100000000000011001100001
100001100000000000000000000000111111111011111111100111000000000001100000000000000000000000000011000001100000111111111000000011111111111000111111000000111111111110001100000111100000000001100000000011111000001101
111101100110111111111000000011111111111011000001100000110000000001101111110000011000111100011011001111000000000000011000001111111111111000000000011110111111111110000000000000000011000000000110110000011001101101
101111100111111111011000011100000111111011001100000000000000000000000000000000011011111111111011000011011000111111011110000011001111111110111111111110111111111110011111111111100011000001100000111111011001101101
101101100000111111011000001100000000000011111100000000000000000000000000000000000000110000011000000000000000000000011001100000000000000000000011100000000000111110011111001110000000111101100111111111111000011111
101101111110111111011110000000000000000111000000000000000000000000000000000000001100110111111110000000000000001100000001100000111101111110000000000001111100111110000000001110000000000001100110000000011000001101
100001111110000000011000000000110000000011001110000000000000000000000000000000001100110000011000001100000000000000000000000000000000011111110000000001111100000000010011111110000000000001100110111111011110001101
110011111111111111111001111111000000000011000000000000000000000000000000000000001111111110011000000001100000000000111111100000000000000000000000000001111111111110011111111111100000000000000110110011000000001101
110010000001000000000001111111000000000011111110000000000000000000000000000000000000000000000000000000000000110011111111101100110110011111111100000000001100000000011111110000000011111101100110110011111000001101
110010011000000000000001111111000000000000000000000000000000000000000000000000001100000000000110000011000000110011000000000000000110000000001100000111111100111111111111000000000000001100000000110000000000001101
110010011001000000100111111111000000000000000000000000000000000000000000000000001100110111100000000000000000110000011111111011111110011111000000011000001100000111100011001111111111110000000000000000111001101101
110010011000001100100000011111110000000000000000000000000000000000000000000000000000110111100000000000000110111111000001111000001110000011001111011001111111100111100000000111111100000000000000000000111000001101
110010011001000000111110011111000000000111001100000000000000000000000000000000001111110110000000000000011110000011011001111111001111111011000011011000000000000111100000000110000000000000000000001111111111111101
110000000000001100000000001111000000000000000000000000000000000000000000000000000000110000000000000000000000000000000001111000000000011011000000000111101100111000000000000110011100000000000001110000000001100001
110000000001001100111000001111000000000111001110000000000000000000000000000000011100111110000011000000000111110011000001111011111110011011000000000001101100000001100000000000011000000000000001000000111001101111
110000000000000000111111101100000000000111000000000000000000000000000000000000011100110110000111000000000000110000000000000011111110000000000000000001101111100001100000000000000011000000000001110000011001101111
110010000001001100000001101100110000000111000000000000000000000000000000000000011000000000000000001111111110110000011001111111111111111011000000000000000000000111100000001000011011000001100000000000011001101111
110010000001001100100001100000000000000111111110000000000000000000000000000000011000110111100111000000000000110000011001100000000111111011000000000111111111000001101100000000000000001101100000000000000000001111
100000000001001100100000001100000000000100000000000000000000000000000000000000011000000001100111001111111111111111011111101111111111111000000000000000000000011001101100001000000011001100000000111111111111111111
100000000110001100000111101100000000000100111110000000000000000000000000000000011000000001100111001111111111111111000001100000110110000011001101100110000000000000000000001000000011000000000000111111100110000011
100000000110001111111000000000000000000100000010000000000000000000000000000000011100111101100111001111111111111111111001111100110110011011001100000000001100000111110000001000000000000000000000111111100110010011
100000011110001111111001111111110000000111110010000000000000000000000000000000000000000000011110111111111111111111111111101100111111111000000000000111111111100110010000000000000011000000000110111111000111110011
100000011110000011000001101111000000000111111110000001111111000000110000000000000000000000011110111111111111111111111111101100111111111000110000011111101100100110010000110000000000000000000110111111000111110011
100000000000000000000000000000000000000111111100000000000000011000000000000111111111110110000011000011111111101100000001111100110000011000000000011000001100000000001100000000000111000000000000111111100000011111
111100000111110011011000001100000000000111111100011001000001111111110000011000000000000000000000000011000000001100000000001100111110011011110000011000001111100000011100000000000100000001100000000011100000000001
100000000000000000011000001100110000000011111100011001001101111111110000000001111111111100000110000011011000000000110111101100000110000000000011000001110011100000011100000000000000110000000000000011000000011101
101110000111110000111001101100000000000011111100000001001100000000000011000000000000111100000110000000011111111111000001100000110111111110111111111111110011100110000000111000011100110000000111000000100000001101
101100000001110000000000000000000000000011000000000001001111100111110000000000000000000000000110111111111000000000000111111100110000011000111111000000000011100110010000111000011100000000000000000000011000001101
111101111001110000111001100000000000000011001110000001001100000111110000000001111100000000000111111111111001111111000001100000110110011011111111111110111111100000010011111000011100000000000000110000000000000001
100001111001111100111000000000000000000011001110000001111101111111110000000001111111111100000000111100000000000000000000000000110000000011110011000000001111111000000011000000000100000010000000000000100000000001
101101111000000000111111111100110000000011001111111001111101111111110000000001111100000000011110111101111111110011110000000000000001111111110011011110001111111111110011001000000000110000000001111100000000000001
101101100000110000000001100000000000000000000001111001111101111111100000110000011000000001111110111100000110000000000000011000000001111111110000011000000000000001110000000000000000000000011000000000000110010001
101101100110110000111000001111000000000111110000011000000001111111101100111110011000001111111111111111111110001111111110011000000001111111111111100001101100100001110000000000011011111111111001111111100000010001
101101100110000000000000001111000000000011000000011001111111000001101100110000011000001110011111111100000000000000110110011000000001100111000000000001100000100000000011111111100000110000000001000000000000000001
101101100000000000000000001111111000000011000010011001110000000001101100110111111000001110000000001111111111111100110110011100001101100111001100011111111111111000000011111111100000110000011111000000000000000001
100000000111111111000000001111111000000000000010011000000011000001101100110111111011111110000000000000011111111100000110000000000001100000001100000001111100000000000000001000000000110000000000001100011111111111
100010011000000000011111111111111110011111110010000000000011111001101100110111111000000000000000001100011111111111111111111000111111111110111100000000111100111110011111001001100000110011111111111100011111111111
100010011001110000011000000000000110011000000000000000110011000000000000000000000000000001100000000000011111100000110000000000111100000110000011111000000000100000010011000001100100000000000000000000000000000001
101100000001000000111001100000000000011000001111111111110011011111100011111110001111000000011011001100011111111100110001111111111101100111110000000000001111100110010011111111100100000011100000000011111111111101
100000011111000000000001110011110110000000000000000110000011011001100000000000000000000000000000000000011111111100110000000000000001100111110000000001100000100110010000111111100100111111100111111111111000000001
110001100000001100000000010011110110011100110011100110111111011001111111000001111100111100000000000011111111111100110000001111111111100111111111111111101100100110010000111111111111111111111111111111111111111111
111111111111111111111111111111111111111111111111111111111111111111111111111111111111111111111111111111111111111111111111111111111111111111111111111111111111111111111111111111111111111111111111111111111111111111