5555555113115555555567855
500000510S015000003000005
4000005100015000005000005111111111111
5000000000000000005000005100000000001
4000005100015000005000005100000000001
5000005100015000005000005100000000001
4000005100015000005000005100000000001
5000005100015000005000005100000000001
5587655100015587655000005100000000001
       100011111111110111100000000001
       100000000000000000000000000003
       111112110111110111100000000001
            5550555550555100000000001
            5000005000005100000000001
            5000005000005100000000001
            5000005000005100000000001
            5000005000005100000000001
            3000003000005100000000001
            55876555876551000111111119999999
                         10001OOOOOOOOOOOOO9
                         10001OOOOOOOOOOOOO9
                         10001OOOOOOOOOOOOO9
                         10001OOOOOOOOOOOOO9
                         10001OOOOOOOOOOOOO9
                         10001OOOOOOOOOOOOO9
                         10001OOOOOOOOOOOOO9
                         10001OOOOOOOOOOOOO9
                         10001OOOOOOOOOOOOO9
                         10000OOOOOOOOOOOOO9
                         10001OOOOOOOOOOOOO9
                         1131199999999999999