AAAAAAAAAAAAAAAAAAAAAAAAAAAAAAAAAAAAAAAAAAAAAAAA
AOOOOOOOOOOOOOOOOOOOOOOOOOOOOOOOOOOOOOOOOOOOOOOA
AO5555555113115555555567855OOOOOOOOOOOOOOOOOOOOA
AO5000005100015000003000005OOOOOOOOOOOOOOOOOOOOA
AO4000005100015000005000005111111111111OOOOOOOOA
AO5000000000000000005000005100000000001OOOOOOOOA
AO4000005100015000005000005100000000001OOOOOOOOA
AO5000005100015000005000005100000000001OOOOOOOOA
AO4000005100015000005000005100000000001OOOOOOOOA
AO5000005100015000005000005100000000001OOOOOOOOA
AO5587655100015587655000005100000000001OOOOOOOOA
AOOOOOOOO100011111111110111100000000001OOOOOOOOA
AOOOOOOOO100000000000000000000000000003OOOOOOOOA
AOOOOOOOO111112110111110111100000000001OOOOOOOOA
AOOOOOOOOOOOOO5550555550555100000000001OOOOOOOOA
AOOOOOOOOOOOOO5000005000005100000000001OOOOOOOOA
AOOOOOOOOOOOOO5000005000005100000000001OOOOOOOOA
AOOOOOOOOOOOOO5000005000005100000000001OOOOOOOOA
AOOOOOOOOOOOOO5000005000005100000000001OOOOOOOOA
AOOOOOOOOOOOOO3000003000005100000000001OOOOOOOOA
AOOOOOOOOOOOOO5587655587655100011111111OOOOOO9OA
AOOOOOOOOOOOOOOOOOOOOOOOOOO10001OOOOOOOOOOOOO9OA
AOOOOOOOOSOOOOOOOOOOOOOOOOO10001OOOOOOOOOOOOO9OA
AOOOOOOOOOOOOOOOOOOOOOOOOOO10001OOOOOOOOOOOOO9OA
AOOOOOOOO4OOOOOOOOOOOOOOOOO10001OOOOOOOOOOOOO9OA
AOOOOOOGGGGGGTGGGOOOOOOOOOO10001OOOOOOOOOOOOO9OA
AOOOOOOGTGGGTTGGGOOOOOOOOOO10001OOOOOOOOOOOOO9OA
AOOOOOOGGGTTGGTTGOOOOOOOOOO10001OOOOOOOOOOOOO9OA
AOOOOOOTTGGGGGGTGOOOOOOOOOO10001OOOOOOOOOOOOO9OA
AOOOOOOOOOOOOOOOOOOOOOOOOOO10001OOOOOOOOOOOOO9OA
AOOOOOOOOOOOOOOOOOOOOOOOOOO10000OOOOOOOOOOOOO9OA
AOOOOOOOOOOOOOOOOOOOOOOOOOO10001OOOOOOOOOOOOO9OA
AOOOOOOOOOOOOOOOOOOOOOOOOOO1131199999999999999OA
AOOOOOOOOOOOOOOOOOOOOOOOOOOOOOOOOOOOOOOOOOOOOOOA
AAAAAAAAAAAAAAAAAAAAAAAAAAAAAAAAAAAAAAAAAAAAAAAA