AAAAAAAAAAAAAAAAAAAAAAAAAAAAAAAAAAAAAAAAAAAAAAAA
AOOOOOOOOOOOOOOOOOOOOOOOOOOOOOOOOOOOOOOOOOOOOOOA
AO5555555113115555555567855OOOOOOOOOOOOOOOOOOOOA
AO500000510S015000003000005OOOOOOOOOOOOOOOOOOOOA
AO4000005100015000005000005111111111111OOOOOOOOA
AO5000000004000000005000005100000000001OOOOOOOOA
AO4000005100015000005000005100000000001OOOOOOOOA
AO5000005104015000005000005100000000001OOOOOOOOA
AO4000005100015000005000005100000000001OOOOOOOOA
AO5000005100015000005000005100000000001OOOOOOOOA
AO5587655100015587655000005100000000001OOOOOOOOA
AOOOOOOOO100011111111110111100000000001OOOOOOOOA
AOOOOOOOO100000000000000000000000000003OOOOOOOOA
AOOOOOOOO111112110111110111100000000001OOOOOOOOA
AOOOOOOOOOOOOO5550555550555100000000001OOOOOOOOA
AOOOOOOOOOOOOO5000005000005100000000001OOOOOOOOA
AOOOOOOOOOOOOO5000005000005100000000001OOOOOOOOA
AOOOOOOOOOOOOO5000005000005100000000001OOOOOOOOA
AOOOOOOOOOOOOO5000005000005100000000001OOOOOOOOA
AOOOOOOOOOOOOO3000003000005100000000001OOOOOOOOA
AOOOOOOOOOOOOO55876555876551000111111119999999OA
AOOOOOOOOOOOOOOOOOOOOOOOOOO10001OOOOOOOOOOOOO9OA
AOOOOOOOOOOOOOOOOOOOOOOOOOO10001OOOOOOOOOOOOO9OA
AOOOOOOOOOOOOOOOOOOOOOOOOOO10001OOOOOOOOOOOOO9OA
AOOOOOOOOOOOOOOOOOOOOOOOOOO10001OOOOOOOOOOOOO9OA
AOOOOOOOOOOOOOOOOOOOOOOOOOO10001OOOOOOOOOOOOO9OA
AOOOOOOOOOOOOOOOOOOOOOOOOOO10001OOOOOOOOOOOOO9OA
AOOOOOOOOOOOOOOOOOOOOOOOOOO10001OOOOOOOOOOOOO9OA
AOOOOOOOOOOOOOOOOOOOOOOOOOO10001OOOOOOOOOOOOO9OA
AOOOOOOOOOOOOOOOOOOOOOOOOOO10001OOOOOOOOOOOOO9OA
AOOOOOOOOOOOOOOOOOOOOOOOOOO10000OOOOOOOOOOOOO9OA
AOOOOOOOOOOOOOOOOOOOOOOOOOO10001OOOOOOOOOOOOO9OA
AOOOOOOOOOOOOOOOOOOOOOOOOOO1131199999999999999OA
AOOOOOOOOOOOOOOOOOOOOOOOOOOOOOOOOOOOOOOOOOOOOOOA
AAAAAAAAAAAAAAAAAAAAAAAAAAAAAAAAAAAAAAAAAAAAAAAA