88888888888888888888888888888888888
8OOOOOOOOOOOOOOOOOOOOOOOOOOOOOOOOO8
8OOO1111111111OOOOOOOOOOOOOOOOOOOO8
8OOO111567111131114141413111311OOO8
8OOO1CCCCCCC10001CCCCCCCC51000111O8
8OOO4CCCCCCC00000CCCCCCCC610000L1O8
8OOO1CCCCCCC10001CCCCCCCC71000111O8
8OOO4CCCCCCC1000111111113110001OOO8
8OOO1CCCCCCC20002CCCCCCCC110001OOO8
8OOO4CCCCCCC10001CCCCCCCC110001OOO8
8OOO1CCCCCCC10000CCCCCCCC110001OOO8
8OOO3CCCCCCC10001CCCCCCCC110001OOO8
8OOO111111111000111766511110001OOO8
8OOO111111111000111121111110001OOO8
8OOO3CCCCCCC1000000000000000001OOO8
8OOO1CCCCCCC1000000000000000001OOO8
8OOO4CCCCCCC1000000000000000001OOO8
8OOO1CCCCCCC1131111121111111111OOO8
8OOO4CCCCCCC10001CCCCCCCC51OOOOOOO8
8OOO1CCCCCCC00000CCCCCCCC61OGTTGTO8
8OOO1117651110001CCCCCCCC71OTGTTGO8
8OOO11111111113111414141111OGTGGGO8
8OOOOOOOOOOOOOOOOOOOOOOOOOOOOOOO888
8OOOOOOOOOOOOOOOOOOOOOOOOOOOOOOO8
8OOOOOOOOOOOOOOOOOOOOOOOOOOOOOOO8
8OOOOOOOOOOOOOOOOOOOOOOOOOOOOOOO8
8OOOOOOOOOOOOOOOOOOOOOOOOOOOOOOO8
888888888888888888888888888888888