         111111111111111111
         10000303C303C1000111
         100001111111C1000001
         1000017CCCCCC1000111
1111111111000016CCCCCC10001
1000000000000015CCCCCC10001
100000000000001111121110001
100000000000000000000000001
100000000000000000000000001
100000000000000000000000001
113111111111111111121110001
1CCC1CCCCCC1000000000000001
1CCC1CCCCCC1000000000000001
1CCC1CCCCCC1000000000000001
1CCC11100111000001121111111
1CCC10000000000001CCCC5
1CCC10000000000000CCLC6
1CCC00000000000001CCCC7
17651111111111111111111