         111111411111111111
         10000303030301000111
         100001111111010000F1
         10000110000001000111
111144111100001400000010001
100000000000001100000010001
100000000000001111121110001
100000000000000000000000001
100000000000000000000000001
100000000000000000000000001
113111111111111111121110001
100010000001000000000000001
100010000001000000000000001
100010000001000000000000001
100011100111000001121111111
10001000000000000100004
10001000000000000000E04
10000000000000000100004
11411111111111111111111