   111 111 111  1111111
   1H1 1H1 1H1  1000001    11111111
1111D111D111D111100000111111000000H
1F000000000000003000003000000111111
1111D111D111D111100000111111000000H
   1H1 1H1 1H1  1000001    11111111
   111 111 111  1111111