   111 111 111  1111111
   1H1 1H1 1H1  1000001   111111111
1111D111D111D111100000111110000000Y
1F000000000000003000001000000211111
1111D111D111D111100000111110000000Y
   1H1 1H1 1H1  1000001   111111111
   111 111 111  1111111