11111111111
10000000001
10H00000001
10000000001
10D00000001
10000000001
10000000001
10000300001
10000F00001
10000000001
11111111111