   111 111 111  1111111
   1H1 1H1 1H1  1000001
1111D111D111D1111000001
1F000000000000003000001
1111D111D111D1111000001
   1H1 1H1 1H1  1000001
   111 111 111  1111111