1113111113111
1000001000001
1000001000001
400N004000004
1000001000001
1000001000001
1110121210111
  101141101
  200000002
  111141111