1112111112111
1000001000001
1000001000001
300N003000003
1000001000001
1000001000001
1110111110111
  101131101
  200000002
  111131111