1112111
1000001
1000001
300N003
1000001
1000001
1111111