1112111
1000001
1000001
300N003
1000001
1000001
1110111
  101
  303
  101
 11011
 10001
 10001
 10001
 11211